X X X X X X X X X X X X X X X X X X X . X
X . . . . . . . . X X . . . . . . . . . X
X . X X X X X X . X X . X X X X X X X . X
X + . . . . . . . . . + . . . . . . . . X
X . X X . X X . X X X X . X X . X X X . X
X . . . . X X . X X X X . X X . . . . . X
X X . X X . . . . D D . . . . X X . X X X
X X . X X . X X . H H . X X . X X . X X X
X X . X X . . . . D D . . . . X X . X X X
. . . . . + X X X X X X X X . . . . . . .
X X . X X . . . . . . . . . . X X . X X X
X X . X X . X X X X X X X X . X X . X X X
X X . X . X X . . . . . . X X . X . X . X
X . . . . . . . X X X X . . . . . . . . X
X . X X X X X X X X X X X X X X X X X . X
X . . . . . . . . . . . . . . . . . . . X
X X X X X X X X X X X X X X X X X X X . X