X X X X X X X X X X X X X X X X X X X X X
X + . . . . . . . . . X X . . . . . . X X
X . X X X X X X X X . X X . X X X X X X X
X . . . . . . . . . . . . . . . . . . . X 
X . X . X X X X X . X X X X . X X . X X X
X . . . . . . X X + X X X . . . X . X + X
X X X . X X . X X . D D D . X . X . . . X
X X X . X X . X X . . H . . X . X X X X X
. . . . . . . X X X X X X X X . . . . . .
X X X . X X . . . . . . . . . . X X X X X
X X X . X X . X X X X X X X X . X . . . X
X . . . . . . X X . . . . . . . X . X . X
X . X . X X X X X . X X X X . X X X X . X
X . . . X X . . . . . . . . . . . . . . X
X . X X X X X X X X . X X . X X X X X X X
X . . . . . . . . . . . . . . . . . . . X
X X X X X X X X X X X X X X X X X X X X X